########
#      #
# 0    #
# ##$  #
#  1   #
#      #
########