########
#      #
# $    #
#      #
# 0 1  #
#      #
########