########
#      #
# $0   #
### ## #
# 10 $ #
#      #
########