########
#      #
#   $  #
#      #
# 10   #
#      #
########