########
#      #
#  ##  #
# 0 $  #
#  1   #
#      #
########