########
#      #
#   $  #
# 0    #
#   1  #
#      #
########