########
#      #
#  0   #
#      #
# $ 1  #
#      #
########