########
#      #
# $    #
#   0  #
# 1    #
#      #
########