########
#      #
# 0 ## #
#   $  #
# 1    #
#      #
########