########
#      #
#  1   #
#   0  #
#   $  #
#      #
########