########
#      #
# ##0  #
# $  # #
# 10 $ #
#      #
########