########
#      #
#  ##  #
#   1  #
# 0 $  #
#      #
########