########
#      #
# $    #
#   1  #
#  0   #
#      #
########