########
#      #
#   0  #
# $    #
#   1  #
#      #
########