########
#      #
# $ ## #
#   0  #
# 1    #
#      #
########