########
#      #
# $    #
# ##0  #
#   1  #
#      #
########