########
#      #
#  $   #
#  0   #
#  1   #
#      #
########