########
#      #
# $ ## #
#0  #  #
# $01  #
#      #
########