########
#      #
#0 $ # #
#  ##  #
# $01  #
#      #
########