########
#      #
# $0   #
# ##   #
# 10 $ #
#      #
########