########
#      #
#0   $ #
#  ##  #
# $01  #
#      #
########