########
#      #
#  0   #
# ##   #
# $ 1  #
#      #
########