########
#      #
# 0 $  #
#      #
#  1   #
#      #
########