########
#      #
# ##   #
# $0   #
#   1  #
#      #
########