########
#      #
#0  ## #
# $    #
# ##10$#
#      #
########