########
#      #
#  $0  #
#      #
# 01$  #
#      #
########