########
#      #
# 1##  #
#  0   #
#   $  #
#      #
########