########
#      #
#  ##  #
# $    #
# 01   #
#      #
########