########
#      #
# $ ## #
# 0    #
# 10 $ #
#      #
########